*****************************************************************
*                               *                               *
*                                                               *
*                                                               *
*                                                               *
*                                                               *
*                                                               *
*                                                               *
*                                                               *
*                                                               *
*                                                               *
*                                                               *
*                                                               *
*                                                               *
*                                                               *
*                                                               *
*                                                               *
*                                                               *
*                                                               *
*                                                               *
*                                                               *
*                                                               *
*                                                               *
*                                                               *
*                                                               *
*                                                               *
*                                                               *
*                                                               *
*                                                               *
*                                                               *
*                                                               *
*                                                               *
*                                                               *
*                                                               *
*                                                               *
*                                                               *
*                                                               *
*                                                               *
*                                                               *
*                                                               *
*                                                               *
*                                                               *
*                                                               *
*                                                               *
*                                                               *
*                                                               *
*                                                               *
*                                                               *
*                                                               *
*                                                               *
*                                                               *
*                                                               *
*                                                               *
*                                                               *
*                                                               *
*                                                               *
*                                                               *
*                                                               *
*                                                               *
*                                                               *
*                                                               *
*                                                               *
*                                                               *
*                                                               *
*                                                               *
*****************************************************************